#Day,F6,F9,F18,F19,F20,F21,F22
0,0,0,0,0,0,1,0
1,0,0,0,0,0,1,0
2,0,0,0,0,0,1,0
3,0,1,0,0,3,1,0
4,0,1,0,0,3,1,0
5,0,1,0,0,3,1,0
6,0,1,0,0,4,1,0
7,0,1,0,0,4,1,0
8,0,1,0,1,4,1,0
9,0,1,0,4,5,1,0
10,5,1,3,6,5,1,0
11,8,1,3,9,5,1,1
12,10,1,3,11,5,1,1
13,12,1,3,9,4,1,1
14,11,1,2,7,3,1,1
15,3,1,2,6,2,1,1
16,3,1,2,4,1,1,1
17,4,1,3,2,3,1,1
18,5,1,3,1,4,1,1