#Day, Default, F1, F2, F3
0,0,1,2,3
1,0,2,2,2
2,0,1,2,3
3,0,1,2,3
4,0,1,2,3
5,0,1,2,3
6,0,1,2,3
7,0,1,2,3
8,0,1,2,3
9,0,1,2,3
10,0,1,2,3
